138
24
100 1 0 0 0 0 0 0 0 0 0 0 0 0 0 0 0 0 0 0 0 0 0 0 0 0 0 0 0 0 0 0 0 0 0 0 0 0 0 0 0 0 0 0 0 0 0 0 0 0 0 0 0 0 0 0 0 0 0 0 0 0 0 0 0 0 0 0 0 0 0 0 0 0 0 0 0 0 0 0 0 0 0 0 0 0 0 0 0 0 0 0 0 0 0 0 0 0 0 0 0 0 0 0 0 0 0 0 0 0 0 0 0 0 0 0 0 0 0 0 0 0 0 0 0 0 0 0 0 0 0 0 0 0 0 5 100 100 
100 1 0 0 0 0 0 0 0 0 0 0 0 0 0 0 0 0 0 0 0 0 0 0 0 0 0 0 0 0 0 0 0 0 0 0 0 0 0 0 0 0 0 0 0 0 6 0 0 0 0 0 0 0 0 0 0 0 0 0 0 0 0 0 0 0 0 0 0 0 0 0 0 0 0 0 0 0 0 0 0 0 0 0 0 0 0 0 0 0 0 0 0 0 0 0 0 0 0 0 0 0 0 0 0 0 0 0 0 0 0 0 0 0 0 0 0 0 0 0 0 0 0 0 0 0 0 0 0 0 0 0 0 0 0 5 100 100 
100 1 0 0 0 0 0 0 0 0 0 0 0 0 0 0 0 0 0 0 0 0 0 0 0 0 0 0 0 0 0 0 0 0 0 0 0 0 0 0 0 0 0 0 0 0 7 0 0 0 0 0 0 0 0 0 0 0 0 0 0 0 0 0 0 0 0 0 0 0 0 0 0 0 0 0 0 0 0 0 0 0 0 0 0 0 0 0 0 0 0 0 8 0 0 0 0 0 0 0 0 0 0 0 0 0 0 0 0 0 0 0 0 0 0 0 0 0 0 0 0 0 0 0 0 0 0 0 0 0 0 0 0 0 0 5 100 100 
100 1 0 0 0 0 0 0 0 0 0 0 0 0 0 0 0 0 0 0 0 0 0 0 0 0 0 0 0 0 0 0 0 0 0 0 0 0 0 0 0 0 0 3 103 103 103 103 103 103 103 2 0 0 0 0 0 0 0 0 0 0 0 0 0 0 0 0 0 0 0 0 0 0 0 0 0 0 0 0 0 0 0 0 0 0 0 0 0 0 0 0 9 0 0 0 0 0 0 0 0 0 0 0 0 0 0 0 0 0 0 0 0 0 0 0 0 0 0 0 0 0 0 0 0 0 0 0 0 0 0 0 0 0 0 5 100 100 
100 103 103 103 103 2 0 0 0 0 0 0 0 0 0 0 0 0 0 0 0 0 0 0 0 0 0 0 0 0 0 0 6 0 0 0 0 0 0 0 0 0 0 5 100 100 100 100 100 100 100 1 0 0 0 0 0 0 0 0 0 0 0 0 0 0 0 0 0 0 0 0 0 0 0 0 0 0 0 0 0 0 0 0 0 3 103 103 103 103 103 103 103 2 0 0 0 0 0 0 0 0 0 0 0 0 0 0 0 0 0 0 0 0 0 0 0 0 0 0 0 0 0 0 0 0 0 0 0 0 0 0 0 0 0 5 100 101 
100 100 100 100 100 1 0 0 0 0 6 0 0 0 0 0 0 0 0 0 0 6 0 0 0 0 0 0 0 0 0 0 7 0 0 0 0 0 0 0 0 0 0 5 100 100 100 100 100 100 100 1 0 0 0 0 0 0 0 0 0 0 0 0 0 0 0 0 0 0 0 0 0 0 0 0 0 0 0 0 0 0 0 0 0 5 100 100 100 100 100 100 100 1 0 0 0 0 0 0 0 0 0 0 17 18 0 0 0 0 0 0 0 0 0 0 0 0 0 0 0 0 0 0 0 0 0 0 0 0 0 0 0 0 0 5 100 16 
100 100 100 100 100 1 0 0 0 0 7 0 0 0 0 0 0 0 0 0 0 7 0 0 0 0 0 0 0 3 103 103 103 103 103 2 3 103 103 103 2 0 0 5 100 100 100 100 0 100 100 1 0 0 0 0 0 0 0 0 0 0 0 0 0 0 0 0 0 0 0 0 0 0 0 0 0 0 0 0 0 0 0 0 0 5 100 100 100 100 100 100 0 0 0 0 0 0 0 0 0 0 0 0 19 20 0 0 0 0 0 0 0 0 0 0 0 0 0 0 0 0 0 0 0 0 0 0 0 0 0 0 0 0 0 5 100 100 
100 100 100 101 100 1 0 3 103 103 103 103 103 103 103 2 0 3 103 103 103 103 103 103 103 2 0 0 0 5 100 100 100 100 100 1 5 100 100 100 1 0 0 5 100 100 101 100 0 0 100 1 0 0 0 0 0 0 0 0 0 0 0 0 22 0 0 0 0 0 0 0 0 0 0 0 0 0 0 0 0 0 0 0 0 5 100 101 100 100 100 0 0 0 0 0 0 3 103 103 103 103 103 103 103 103 103 103 103 103 103 103 103 103 2 0 0 0 0 0 0 0 0 0 0 0 0 0 0 0 0 0 0 0 0 5 100 100 
100 100 100 102 100 1 0 5 100 101 100 100 100 101 100 1 0 5 100 100 100 100 100 100 100 1 0 0 0 5 100 100 100 100 100 1 5 100 100 100 1 0 0 5 100 100 11 100 0 0 100 1 0 0 0 0 0 0 3 103 103 103 103 103 103 103 2 0 0 0 0 0 0 0 0 0 0 0 0 0 0 0 0 0 0 5 100 102 100 100 0 0 0 0 0 0 0 5 100 100 100 100 100 100 100 100 100 100 100 100 100 100 100 0 0 0 0 0 0 0 0 0 0 0 0 0 0 0 0 0 0 0 0 0 0 5 100 100 
100 100 100 100 100 1 0 5 100 102 100 100 100 102 100 1 0 5 100 101 100 100 100 100 100 1 0 0 0 5 100 100 101 100 100 1 5 100 100 100 1 0 0 5 100 100 100 0 0 100 100 1 0 0 0 0 0 0 5 100 100 100 100 0 100 100 1 0 0 0 0 0 0 0 0 0 0 0 0 0 0 0 0 0 0 5 100 100 100 0 0 0 0 0 0 0 0 5 100 100 100 100 100 100 100 100 100 100 100 100 100 100 100 0 0 0 0 0 0 0 0 0 0 0 0 0 0 0 0 0 0 0 0 0 0 5 100 100 
100 100 100 100 100 1 0 5 100 100 100 100 100 100 100 1 0 5 100 16 100 0 100 0 100 1 0 0 0 5 100 100 21 100 100 1 5 100 100 100 1 0 0 5 100 100 0 0 0 100 100 1 0 0 0 0 0 0 5 100 100 101 100 0 0 100 1 0 0 0 0 0 0 0 0 0 0 0 0 0 0 0 0 0 0 5 100 100 100 0 0 0 0 0 0 0 0 0 0 0 100 100 100 100 100 100 100 100 100 100 100 100 0 0 0 0 0 0 0 0 0 0 0 0 0 0 0 0 0 0 0 0 0 0 0 5 100 100 
100 100 100 100 100 1 0 5 100 100 100 100 100 100 100 1 0 5 100 100 0 0 0 0 100 1 0 0 0 5 100 100 100 100 100 1 5 100 100 100 1 0 0 5 100 100 0 0 0 100 100 1 0 0 0 0 0 0 5 100 100 11 100 0 100 100 1 0 0 0 0 0 0 0 0 0 0 0 0 0 0 0 0 0 0 5 100 100 100 100 0 0 0 0 0 0 0 0 0 0 0 100 100 100 100 100 100 100 100 100 100 0 0 0 0 0 0 0 0 0 0 0 0 0 0 0 0 0 0 0 0 0 0 0 0 5 100 101 
100 100 100 101 100 1 0 5 100 101 100 100 100 101 100 1 0 5 100 100 100 0 0 100 100 1 0 0 0 5 100 100 100 100 100 1 0 0 0 0 0 0 0 5 100 0 0 0 0 100 100 1 0 0 0 0 0 0 5 100 0 100 0 0 0 100 1 0 0 0 0 0 0 0 0 0 0 0 0 0 0 0 0 0 0 5 100 100 100 100 100 0 0 0 0 0 0 0 0 0 0 100 100 100 100 100 100 100 100 100 0 0 0 0 0 0 0 0 0 0 0 0 0 0 0 0 0 0 0 0 0 0 0 0 0 5 100 102 
100 100 100 11 100 1 0 5 100 11 100 100 100 102 100 1 0 5 100 100 100 0 0 100 100 1 0 0 0 5 100 100 100 100 100 1 0 0 0 0 0 0 0 5 100 0 0 0 100 101 100 1 0 0 0 0 0 0 5 100 0 0 0 0 0 100 1 0 0 0 0 0 0 0 0 0 0 0 0 0 0 0 0 0 0 5 100 100 100 100 0 0 0 0 0 0 0 0 0 0 0 0 0 100 100 100 100 100 100 0 0 0 0 0 0 0 0 0 0 0 0 0 0 0 0 0 0 0 0 0 0 0 0 0 0 5 100 100 
100 100 100 100 100 1 0 5 100 100 100 100 100 100 100 1 0 5 100 100 100 0 0 100 100 1 0 0 0 55 100 100 100 100 100 1 0 0 0 0 0 0 0 0 0 0 100 100 100 16 100 1 0 0 0 0 0 0 0 0 0 0 0 0 0 0 0 0 0 0 0 0 0 0 0 0 0 0 0 0 0 0 0 0 0 5 100 100 0 0 0 0 0 0 0 0 0 0 0 0 0 0 0 100 100 100 100 100 0 0 0 0 0 0 0 0 0 0 0 0 0 0 0 0 0 0 0 13 0 0 0 0 0 0 0 5 100 100 
100 100 100 100 100 1 0 5 100 100 100 100 100 100 100 1 0 5 100 100 0 0 0 100 100 1 0 0 0 57 100 100 100 100 0 0 0 0 0 0 0 0 0 0 0 0 53 100 100 100 100 1 0 0 0 0 0 0 0 0 0 0 0 0 0 0 0 0 0 0 0 0 8 0 0 0 0 0 0 0 0 0 0 0 0 5 100 100 0 0 0 0 0 0 0 0 0 0 0 0 0 0 0 0 100 100 100 0 0 0 0 0 0 0 0 0 0 0 0 0 0 0 0 0 0 0 0 12 0 0 0 0 0 0 0 5 100 100 
100 100 100 100 100 1 0 5 100 101 100 100 100 101 100 1 0 5 100 0 0 0 0 0 100 1 0 0 0 59 100 100 100 0 0 0 0 0 0 0 0 13 0 0 0 0 54 100 100 100 100 1 0 0 0 0 0 0 0 0 0 0 0 0 0 0 0 0 0 0 0 0 9 0 0 0 0 0 0 0 0 0 0 0 0 5 100 100 100 0 0 0 0 0 0 0 0 0 0 0 0 0 0 0 0 0 0 0 0 0 0 0 0 0 0 0 0 0 0 0 0 0 0 0 0 0 0 12 0 0 0 0 0 0 0 5 100 100 
100 100 100 101 100 1 0 5 100 21 100 100 100 21 100 1 0 5 100 100 100 0 0 0 100 1 0 0 0 59 100 0 0 0 0 0 0 0 0 0 0 12 0 0 0 5 100 100 100 100 100 1 0 0 0 0 0 0 0 17 18 0 0 0 0 0 0 0 0 0 0 0 10 0 0 0 0 0 0 0 0 0 0 0 0 5 100 100 100 100 0 0 0 0 0 0 0 0 0 0 0 23 24 25 26 27 28 0 0 0 0 0 0 0 0 0 0 0 0 0 0 0 0 0 0 0 0 12 0 0 0 0 0 0 0 5 100 100 
100 100 100 102 100 1 0 5 100 100 100 100 100 100 100 1 0 5 100 100 100 100 0 0 100 1 0 0 0 59 100 100 0 0 0 0 0 0 0 0 0 12 0 0 5 100 100 100 100 101 100 1 0 0 0 0 0 0 0 19 20 0 0 0 0 0 0 0 3 103 103 103 103 2 0 0 0 0 0 0 0 0 0 0 0 5 100 100 100 100 100 0 0 0 0 0 0 0 0 0 0 29 30 31 32 33 34 0 0 0 0 0 0 0 0 0 0 0 0 0 0 0 0 0 0 0 0 12 0 0 0 0 0 0 0 5 100 100 
100 100 100 100 100 1 0 5 100 100 100 100 100 100 100 1 0 5 100 100 0 0 0 0 100 1 0 0 0 59 100 100 0 0 0 0 0 0 0 0 0 12 0 5 100 100 100 100 100 102 100 1 0 0 0 0 3 103 103 103 103 103 103 2 0 0 0 0 5 100 101 100 100 1 0 0 0 0 0 0 0 0 0 0 0 5 100 100 100 100 100 100 0 0 0 0 0 0 0 0 0 35 36 37 38 39 40 0 0 0 0 0 0 0 0 0 0 0 0 0 0 0 0 0 0 0 0 12 0 0 0 0 0 0 0 5 100 100 
100 100 100 100 100 1 0 5 100 100 100 53 100 100 100 1 0 5 100 100 100 0 0 0 100 1 0 0 0 59 100 0 0 0 3 103 103 103 103 103 2 12 0 5 100 100 100 100 100 100 100 1 0 0 0 0 5 100 101 101 101 101 100 1 0 0 0 0 5 100 21 100 100 1 0 0 0 0 0 0 0 0 0 0 0 5 100 100 100 100 100 100 100 1 0 0 0 0 0 0 0 41 42 43 44 45 46 0 0 0 0 0 0 0 0 0 0 0 0 0 0 0 0 0 0 0 0 12 0 0 0 0 0 0 0 5 100 100 
100 100 100 100 53 1 0 5 100 100 100 54 100 100 100 1 0 5 100 100 0 0 100 100 100 1 0 0 0 61 100 100 0 0 5 100 100 100 100 100 1 12 0 5 100 100 100 100 100 100 100 1 0 0 0 0 5 100 102 11 102 16 100 1 0 0 0 0 5 100 100 100 100 1 0 0 0 0 0 0 0 0 17 18 0 0 53 100 100 100 100 100 100 1 0 0 0 0 0 0 0 0 47 48 49 0 0 0 0 0 0 0 0 0 0 0 0 0 0 0 0 0 0 0 0 0 0 12 0 0 0 0 0 0 0 0 53 100 
100 100 100 100 54 68 63 15 14 15 14 15 14 15 14 15 14 15 14 15 14 15 14 15 14 15 14 68 14 15 14 15 14 15 14 15 14 15 14 15 14 15 14 68 100 100 100 100 100 100 100 1 0 0 0 0 5 100 100 100 100 100 100 1 0 0 0 0 5 100 100 100 100 1 0 0 0 0 0 0 0 14 66 67 15 14 54 100 100 100 100 100 100 1 0 0 0 0 0 0 0 14 15 69 70 14 15 14 0 0 0 0 0 0 0 0 0 0 0 14 15 14 15 14 15 14 15 65 15 14 15 14 15 14 15 14 54 100 
114 115 114 115 114 115 114 115 114 115 114 115 114 115 114 115 114 115 114 115 114 115 114 115 114 115 114 115 114 115 114 115 114 115 114 115 114 115 114 115 114 115 114 115 114 115 114 115 114 115 114 115 114 115 114 115 114 115 114 115 114 115 114 114 115 114 115 114 115 114 115 114 115 0 0 0 0 0 0 0 0 114 115 114 115 115 114 115 114 115 114 115 114 0 0 0 0 0 0 0 0 114 115 114 115 114 115 114 0 0 0 0 0 0 0 0 0 0 0 114 115 114 115 114 115 114 115 114 115 114 115 114 115 114 115 114 115 114 
