184
8
22 4 0 0 0 0 0 0 0 0 0 0 0 0 0 0 0 0 0 0 0 0 0 0 0 0 0 0 0 0 0 0 0 0 0 0 0 0 0 0 0 0 0 0 0 0 0 0 0 0 0 0 0 0 0 0 3 22 22 22 22 22 22 22 22 22 22 22 22 22 22 22 22 22 22 22 22 22 22 22 22 22 22 22 22 22 22 22 22 22 4 0 0 0 0 0 0 0 3 22 22 22 22 22 22 22 22 22 22 22 22 22 22 22 22 22 22 22 22 22 22 22 22 22 22 22 22 22 22 22 22 22 22 22 22 22 4 0 0 0 0 0 0 0 0 0 0 0 0 0 0 0 0 0 0 0 0 0 0 0 0 0 0 3 22 22 22 22 22 22 4 0 0 0 0 0 0 0 0 0 0 0 3 22 
22 4 0 0 0 0 0 0 0 0 0 0 0 0 0 0 0 0 0 0 0 0 0 0 0 0 0 0 0 0 0 0 0 0 11 0 0 0 0 0 0 0 0 0 0 0 0 0 0 0 0 0 0 0 0 0 3 22 22 22 22 22 22 22 22 22 22 22 22 22 22 22 22 22 22 22 22 22 22 22 22 22 22 22 22 22 22 22 22 19 0 0 0 0 0 0 0 0 0 17 17 17 17 17 17 17 17 17 17 17 17 17 17 17 17 17 17 17 17 17 17 17 17 16 13 13 13 13 13 13 13 13 19 17 17 17 0 0 0 0 0 0 0 0 0 0 0 0 0 0 0 0 0 0 0 0 0 0 0 0 0 0 0 0 17 17 17 17 17 17 0 0 0 0 0 0 0 0 0 0 0 0 3 22 
22 4 0 0 0 0 0 0 0 0 0 0 0 0 0 0 0 0 0 0 0 0 0 0 0 0 0 0 0 0 0 0 0 0 23 25 0 0 0 0 0 0 0 0 0 0 0 0 0 0 0 0 0 0 0 0 0 17 17 17 17 17 17 17 17 17 17 17 17 17 17 16 13 13 13 19 17 17 17 17 17 18 13 13 13 13 13 13 19 0 0 0 0 0 0 0 0 0 0 0 0 0 0 0 0 0 1 21 21 21 21 21 21 21 21 21 21 21 21 21 2 0 3 22 22 22 22 22 22 22 22 22 22 4 0 0 0 0 0 0 0 0 0 11 0 0 0 0 0 0 0 0 0 0 0 0 0 0 0 0 0 0 0 0 0 3 22 22 4 0 0 0 0 0 0 0 0 0 0 0 0 0 3 22 
22 4 0 0 0 0 0 0 0 0 0 0 0 0 9 9 0 0 0 0 0 0 0 0 0 0 9 9 9 9 0 0 0 0 0 0 0 0 0 0 0 0 0 0 0 23 24 25 0 0 0 0 0 0 23 24 25 22 22 22 22 22 22 22 22 4 0 11 0 0 15 22 22 22 19 0 9 9 9 9 0 3 22 22 22 22 22 19 0 0 0 9 0 0 0 0 11 11 0 0 0 0 0 9 0 0 0 17 18 22 22 22 22 22 22 22 22 22 22 22 4 0 3 22 22 22 22 22 22 22 22 20 17 0 0 0 0 0 0 0 23 24 24 24 25 0 0 0 0 0 0 0 0 0 0 0 0 0 0 0 0 0 0 0 3 22 22 22 22 4 0 0 0 0 0 0 0 0 0 0 0 0 3 22 
22 4 0 0 0 0 0 0 0 0 0 0 10 1 21 21 2 0 0 0 0 0 0 0 0 0 23 24 24 25 0 0 0 0 0 0 0 0 0 0 11 11 0 0 0 0 0 0 0 0 0 0 0 0 0 0 3 22 22 22 22 22 22 22 19 0 3 22 4 3 22 22 22 19 0 3 22 22 22 22 4 0 17 18 22 22 19 0 0 3 22 22 4 0 0 3 22 22 4 0 0 0 3 22 22 4 0 9 3 22 22 22 22 22 22 22 22 22 22 22 22 4 0 17 18 22 22 22 22 22 20 0 0 0 0 0 0 11 0 0 0 0 0 0 0 0 0 0 0 0 0 0 0 0 0 10 0 0 0 0 0 0 0 11 11 17 18 22 22 22 4 11 0 0 0 0 0 0 0 0 0 0 3 22 
22 4 0 0 0 0 0 0 0 0 9 1 12 12 6 22 4 0 0 0 0 0 9 0 0 0 0 0 0 0 0 0 0 0 0 0 0 0 0 0 23 25 0 0 0 0 0 0 0 23 25 0 0 0 0 0 3 22 22 22 22 22 22 19 0 3 22 22 4 0 18 22 19 0 3 22 22 22 22 22 22 4 0 0 17 17 0 0 0 0 17 17 0 0 0 0 17 17 0 0 0 0 0 17 17 0 3 22 22 22 22 20 17 17 17 17 18 22 22 22 22 22 22 4 9 17 17 17 17 17 0 0 0 0 0 23 24 25 0 0 0 0 0 0 0 0 0 0 0 0 0 0 0 0 0 23 25 0 0 0 0 0 0 23 25 0 0 18 22 22 22 22 4 0 0 0 0 0 0 0 0 0 3 22 
22 4 0 0 0 0 0 0 0 1 21 21 6 13 22 22 4 0 0 0 0 23 25 0 0 10 10 10 0 0 0 0 0 0 0 9 0 0 0 0 0 0 0 0 10 10 10 0 0 0 0 0 0 0 0 10 0 17 17 17 17 17 17 0 3 22 22 22 22 4 0 17 0 3 22 22 22 22 22 22 22 22 4 9 9 9 3 22 22 4 0 0 0 10 10 10 10 10 0 0 0 0 0 9 9 9 3 22 22 22 20 0 0 0 0 0 0 17 17 17 17 18 22 22 22 22 22 4 10 0 0 0 0 0 0 0 0 0 0 0 0 0 0 0 0 0 0 0 0 0 0 9 0 0 0 0 0 0 0 0 0 11 11 0 11 0 0 3 22 22 22 22 22 4 11 11 11 0 0 11 11 11 3 22 
5 21 21 21 21 21 21 21 21 21 22 22 13 13 22 22 4 0 0 0 0 0 0 0 1 12 12 12 2 0 0 0 0 0 1 21 21 2 0 0 0 26 26 1 12 12 12 2 0 0 0 0 0 1 21 21 8 21 21 21 21 21 21 21 21 6 22 22 22 22 22 22 22 22 22 22 22 22 22 22 22 22 22 22 22 22 22 22 22 4 0 0 3 13 13 13 13 13 4 0 0 3 22 22 22 22 22 22 22 20 0 0 0 0 0 0 0 0 0 0 0 0 17 18 22 22 22 22 22 4 0 23 25 0 0 0 0 0 0 0 0 0 0 0 0 0 0 0 0 0 23 24 25 0 0 0 0 0 0 0 0 23 24 24 24 25 0 0 18 22 22 22 22 22 22 22 22 4 3 22 22 22 22 22 
